3 3 3 3 3 3 3 3 3 2 2 2 2 2 2 6 6 6 6 6 6 6 6 6 6 6 6 6
3 1 0 0 7 0 0 8 3 2 0 0 0 0 8 0 0 0 0 0 0 0 0 0 0 0 6 6
3 0 0 0 0 0 7 0 3 2 0 0 0 2 2 6 0 0 0 1 0 0 0 1 0 0 6 6
3 0 0 0 7 0 0 0 3 2 0 4 0 0 2 6 0 1 0 0 0 0 0 0 8 0 6 6
3 0 0 0 0 0 7 0 3 2 0 0 0 0 2 6 0 0 0 0 0 0 1 0 0 0 6 6
3 0 0 7 0 0 0 0 3 2 0 0 4 0 2 6 0 0 0 1 0 1 0 0 0 4 6 6
3 7 0 0 0 7 0 0 3 2 0 0 0 0 2 6 0 0 0 0 0 0 0 0 0 4 6 6
3 8 0 0 0 0 0 0 8 0 0 0 0 4 2 6 0 0 0 0 1 0 0 0 0 0 10 6
3 3 3 3 3 3 3 3 3 2 2 2 2 2 2 6 6 6 6 6 6 6 6 6 6 6 6 6
