5 5 5 5 5 5 5 5 5 5 5 5 5 5 5 5 5 5 5
5 0 0 0 5 0 0 0 0 0 0 0 5 0 0 0 0 0 5
5 0 5 0 5 5 5 5 0 0 5 0 5 5 5 5 5 0 5
5 5 5 0 5 0 0 0 0 0 5 0 5 0 0 0 0 0 5
5 0 0 0 5 0 5 5 5 0 5 0 5 0 5 0 6 6 6
5 0 0 0 5 0 0 0 5 0 5 0 0 8 5 0 6 0 6
5 0 5 0 5 5 5 0 5 5 5 5 5 5 5 0 6 0 6
5 0 5 0 0 0 0 0 0 0 0 0 5 0 0 0 6 0 6
5 0 5 8 5 5 5 5 5 5 5 5 5 0 5 5 6 0 6
5 0 5 5 5 0 0 0 9 6 0 0 0 0 0 0 6 0 6
5 0 0 0 0 0 6 6 6 6 0 6 6 6 6 0 6 0 6
5 0 6 6 6 6 6 0 8 6 6 6 0 0 0 0 0 0 6
5 8 6 0 0 6 0 0 0 0 0 0 0 0 6 6 6 0 6
5 6 6 0 6 6 0 6 0 0 0 0 0 8 6 0 6 0 6
6 0 0 0 0 6 0 6 6 6 6 0 6 6 6 0 6 6 6
-1 0 0 6 0 0 0 0 0 0 6 0 6 0 0 0 0 0 6
6 6 0 6 6 6 6 6 6 0 6 0 6 6 6 6 6 0 6
6 0 0 0 0 0 0 0 6 0 6 0 0 0 0 0 0 0 6
6 6 6 6 6 6 6 6 6 6 6 6 6 6 6 6 6 6 6
