1 1 1 1 1 1 1
1 0 0 0 0 0 1
1 0 1 1 1 0 1
1 0 0 0 0 0 1
1 0 0 0 0 0 7
1 0 0 0 0 0 6
1 1 1 1 5 5 5
