3 3 3 3 3 3 3 3 3 3 3 3 3 3 3 3 3 3 3 3 3 3 3 3 3 3 3 3 3 3 3 3 3 3 3 3 3 3 3 3
3 0 0 0 0 0 3 0 0 0 0 0 0 0 3 0 0 0 3 0 0 0 3 0 0 0 0 0 3 0 0 0 0 0 0 0 0 0 0 3
3 0 3 3 3 0 3 0 3 3 3 0 8 0 3 0 3 0 3 0 3 0 3 0 3 3 3 0 3 0 0 0 0 0 0 0 0 0 0 3
3 0 0 0 3 0 3 0 3 0 3 0 0 0 3 0 3 0 3 0 3 0 3 0 3 3 3 0 3 0 0 0 0 0 0 3 3 3 3 3
3 0 3 0 0 0 0 0 0 0 0 3 3 3 3 0 3 0 0 0 3 0 3 0 0 0 3 0 3 0 0 0 0 0 0 3 0 0 9 3
3 0 3 0 3 0 3 3 3 0 0 0 3 0 0 0 3 3 3 3 3 0 3 3 3 0 3 0 3 0 0 0 0 0 0 3 0 3 3 3
3 3 0 0 3 0 0 0 3 7 0 0 3 0 3 3 3 8 8 8 3 0 0 0 3 0 3 0 3 0 0 0 0 0 0 0 0 0 0 3
3 0 0 0 0 0 3 0 3 0 0 0 0 0 3 0 0 0 0 0 0 0 3 0 0 0 3 0 0 0 0 0 0 0 0 0 0 0 0 3
3 3 3 3 3 3 3 3 3 3 3 3 3 3 3 3 3 3 3 3 3 3 3 3 3 3 3 3 3 3 3 3 3 3 3 3 3 3 3 3
